1111111111
1000000001
1000000001
1000000001
1030000001
1020000001
1012000211
1111001111