1111111111
0000000001
0000000001
0000000001
0000000001
0000000001
1402123021
1111111111