1111111111
0000000001
0000000001
0000000001
0000000001
0000000001
1002003021
1111001111