1111001111
0000000001
0000010001
0000110001
0000220001
0000000001
1102003021
1111001111