1111111111
0000000000
0000000000
0000000000
0000000000
0000003000
0114001110
1111111111