1111111111
2002220020
0000000000
0000000000
0000000000
0110000000
0111021212
1111111111