1111111111
1212111111
0000222111
0000002111
0000000000
0000000000
0000000001
1110000011