1111111111
0000110000
0000000000
0000000000
0000000000
0000000000
0000000300
1111001111