0000000000
0111000000
0221000000
0000011120
0000021110
0000000000
0000000000
1100111111