1111001111
0100000000
0000000000
0000110000
0000000000
0000000000
0100000301
1111001111