1111001111
0100000000
0000000000
0000110000
0000000000
0020010000
0124110301
1111111111