1111001111
0100000001
0000000001
0000110001
0000000001
0020010001
0120114301
1111111111