1111111111
1010000010
1000000000
1000000000
1000000000
1000000000
1010304000
1111111111