1111111111
1010000010
1000000000
1000000000
1000000000
1030000000
1010000000
1111001111