1111001111
1010002210
1000000000
1000000000
1000000000
1030001000
1014001100
1111111111