1111001111
1010002211
1000000001
1000000001
1000000001
1030001001
1012241121
1111111111