1111001111
1210002211
1000000021
1200000001
1000000001
1030001021
1012001121
1111001111